   0 1 2 3 4 5 6 7 8 

0  T 1 2 2 2 2 2 1 T
1  1 1 2 2 2 2 2 1 1
2  2 2 2 2 2 2 2 2 2
3  2 2 2 3 4 3 2 2 2
4  2 2 2 4 T 4 3 2 2
5  2 2 2 3 4 3 2 2 2
6  2 2 2 2 2 2 2 2 2
7  1 1 2 2 2 2 2 1 1
8  T 1 2 2 2 2 2 1 T
